1111111111111111111111111
1E00000100000000000000001
1000000000001000000010001
1001000000000000000000001
1000000000000000000100001
1000001001000000000100001
1001001001000000000000001
1111111111111111111111111