11111111111111
1E000001000001
10000000000011
10010010010001
11111111111111