1111111111111
1100000000001
1101000000001
1000000000001
1N01000000001
1111111111111