NO Sources/school.png
SO Sources/Shakira.png
WE Sources/ysahih.png
EA Sources/party.png
F 111,18,49
C 54,54,54

111111111111111111111
101000000010000000001
101000000010000000001
1N0000000100000001001
101001001010101000001
111111111111111111111