11111111111
1000E010011
11000000011
11000101011
11111111111