1111111111111111111111111111111111
1010000000011110000000000000000001
1P0000000C00C000010000000000000001
101001001010101000E001000000010111
1111111111111111111111111111111111