111111111
1E0000001
100000001
100000001
100000001
100000001
100000001
100000001
100000001
100000001
111111111