1111111111111111111111111111
1000000000100000010000110001
1000001000001000000001000101
1010010001000100010010010001
1001000000000000000010010111
1000010000001000010000110111
1011000000000000000000100111
1E01000000000000100000000111
1111111111111111111111111111