NO Sources/school.png
SO Sources/school1.png
WE Sources/school2.png
EA Sources/school3.png
F 50,205,50
C 0,255,255

    1111111111111111111 1
1111100S010000000011
101000000010000000001
100000000100000001001
101001001010101000001
101001001010101000001
101001001010101000001
101001001010101000001
101001001010101000001
101001001010101000001
111111111111111111111
