NO Sources/school.png
SO Sources/school1.png
WE Sources/school2.png
EA Sources/school3.png
F 11,205,50
C 123,255,255

    1111111111111111111 1
1111100S010000000011
111111111111111111111







