1111111111
1000S01001
1111111111