NO ./path_to_the_north_texture
EA ./path_to_the_east_texture
SO ./path_to_the_south_texture 
F 255,100,0
WE ./path_to_the_west_texture
C 225,30,0


11111111
1N000011
11111111