1111111111111
100000D000001
10E0000D000D1
100000000D001
10000000P0001
1000000000001
10C000D000001
1111111111111